0 0 0 0 36 0 0 0 36 0 0 0 0 0 0 0 0 0 0 0 0 0 36 0 0 0 0 0 0 0
0 0 0 0 46 0 0 0 46 0 0 0 0 36 0 0 36 0 0 36 0 0 46 0 0 0 0 36 0 0
0 0 0 36 0 0 0 0 0 0 0 36 0 46 0 0 46 0 0 46 0 0 0 0 0 0 0 46 0 0
0 0 0 46 0 0 0 0 36 0 0 46 0 0 0 0 0 0 0 0 0 0 0 36 0 0 0 0 0 0
0 0 0 0 0 0 0 0 46 0 0 0 0 0 0 0 36 0 0 0 0 0 0 46 0 0 0 0 0 36
0 0 0 36 0 0 36 0 0 0 0 0 0 36 0 0 46 0 0 0 0 0 36 0 0 0 36 0 0 46
0 0 0 46 0 0 46 0 0 0 0 0 0 46 0 0 0 0 0 0 0 0 46 0 0 0 46 0 0 0
0 0 0 0 0 0 0 0 0 36 0 0 36 0 0 36 0 0 0 36 0 0 0 0 0 0 0 0 0 0
0 0 36 0 0 0 0 0 0 46 0 0 46 0 0 46 0 0 0 46 0 0 0 0 0 0 0 0 0 0
0 0 46 0 0 0 0 0 0 0 0 0 0 0 0 0 0 0 0 0 0 0 36 0 0 0 36 0 36 0
0 0 0 0 0 0 36 0 0 0 0 36 0 0 0 0 0 0 0 0 0 0 46 0 36 0 46 0 46 0
0 36 0 0 0 0 46 0 0 0 0 46 0 0 36 0 0 0 36 0 0 0 0 0 46 0 0 0 0 0
0 46 0 0 0 0 0 0 0 0 0 0 0 0 46 0 0 0 46 0 0 0 0 0 0 0 0 0 36 0
0 0 36 0 36 0 0 0 0 0 0 0 0 0 0 0 0 36 0 0 36 0 0 0 36 0 0 0 46 0
0 0 46 0 46 0 18 19 20 0 0 0 0 0 0 0 0 46 0 0 46 0 0 0 46 0 36 0 0 0
0 0 0 0 0 0 28 29 30 0 0 0 0 0 0 0 0 0 0 0 0 0 0 0 0 0 46 0 0 0
0 0 0 0 0 0 38 39 40 25 0 45 37 0 0 0 0 0 36 0 0 0 0 0 0 0 0 0 0 0
0 0 0 36 0 0 48 49 50 25 0 0 47 0 45 0 0 0 46 0 0 0 0 0 0 0 0 0 0 0
0 36 0 46 0 0 0 0 0 0 0 45 0 25 0 0 0 0 0 0 0 36 0 0 0 0 36 0 0 0
0 46 0 0 0 0 0 0 0 0 0 0 0 0 0 0 0 0 0 0 0 46 0 0 36 0 46 0 36 0
0 0 0 0 36 0 0 0 0 0 0 0 0 0 0 0 0 0 0 0 0 0 0 36 46 0 36 0 46 0
0 0 0 0 46 0 0 0 0 0 0 0 0 0 0 0 0 0 0 36 0 0 0 46 0 0 46 0 0 0
0 0 0 0 0 0 0 0 0 0 0 0 0 0 0 0 0 0 0 46 0 0 0 0 0 0 0 0 0 0
0 18 19 20 0 0 0 0 0 0 0 0 0 0 0 0 36 0 0 0 0 0 0 0 0 0 36 0 0 0
0 28 29 30 36 0 0 0 0 0 0 36 0 0 36 0 46 0 36 0 0 36 0 0 36 0 46 0 36 0
0 38 39 40 46 0 0 0 0 0 0 46 0 0 46 0 0 0 46 0 0 46 0 0 46 0 0 0 46 0
0 48 49 50 0 0 0 0 36 0 0 0 0 0 0 36 0 0 0 0 0 0 0 0 0 0 36 0 0 0
0 0 0 0 0 0 0 0 46 0 0 36 0 0 0 46 0 0 36 0 0 0 36 0 0 0 46 0 36 0
0 36 0 0 0 0 36 0 0 0 0 46 0 0 0 0 0 0 46 0 0 0 46 0 36 0 0 0 46 0
0 46 0 0 0 0 46 0 0 0 0 0 0 0 0 0 0 0 0 0 0 0 0 0 46 0 0 0 0 0