0 0 0 0 0 0 0 0 0 0 0 0 0 0 0 0 0 0 0 0 0 0 0 0 0 0 0 0 0 0
0 0 0 0 0 0 0 0 0 0 0 0 0 0 0 0 0 0 0 0 0 0 0 0 0 0 0 0 0 0
0 0 0 0 0 0 0 0 0 0 0 0 0 0 0 0 0 0 0 0 0 0 0 0 0 0 0 0 0 0
0 0 0 0 0 0 0 0 0 0 0 0 0 0 0 0 0 0 0 0 0 0 0 0 0 0 0 0 0 0
0 0 0 0 0 0 0 0 0 0 0 0 0 0 0 0 0 0 0 0 0 0 0 0 0 0 0 0 0 0
0 0 0 0 0 0 0 0 0 0 0 0 0 0 0 0 0 0 0 0 0 0 0 0 0 0 0 0 0 0
0 0 0 0 0 0 0 0 0 0 0 0 0 0 0 0 0 0 0 0 0 0 0 0 0 0 0 0 0 0
0 0 0 0 0 0 0 0 0 0 0 0 0 0 0 0 0 0 0 0 0 0 0 0 0 0 0 0 0 0
0 0 0 0 0 0 0 0 0 0 0 0 0 0 0 0 0 0 0 0 0 0 0 0 0 0 0 0 0 0
0 0 0 0 0 0 0 0 0 0 0 0 0 0 0 0 0 0 0 0 0 0 0 0 0 0 0 0 0 0
21 21 21 21 21 21 21 21 21 21 21 21 21 21 21 21 21 21 21 21 0 0 0 0 0 0 0 0 0 0
21 21 21 21 21 21 21 21 21 21 21 21 21 21 21 21 21 21 21 21 0 0 0 0 0 0 0 0 0 0
21 21 21 21 21 21 21 21 21 21 21 21 21 21 21 21 21 21 21 21 0 0 0 0 0 0 0 0 0 0
21 21 21 21 21 21 21 21 21 12 12 12 21 21 21 21 21 21 21 21 0 0 0 0 0 0 0 0 0 0
21 21 21 21 21 21 21 21 12 12 12 12 12 21 21 21 21 21 21 21 0 0 0 0 0 0 0 0 0 0
21 21 21 21 21 21 21 12 12 12 12 12 12 12 12 21 21 21 21 21 0 0 0 0 0 0 0 0 0 0
21 21 21 21 21 21 12 12 12 12 12 12 12 12 12 12 21 21 21 21 0 0 0 0 0 0 0 0 0 0
21 21 21 21 21 21 12 12 12 12 12 12 12 12 12 12 12 21 21 21 0 0 0 0 0 0 0 0 0 0
21 21 21 21 21 21 12 12 12 12 12 12 12 12 12 12 12 12 21 21 0 0 0 0 0 0 0 0 0 0
21 21 21 21 21 21 12 12 12 12 12 12 12 12 12 12 12 12 21 21 0 0 0 0 0 0 0 0 0 0
21 21 21 21 21 21 12 12 12 12 12 12 12 12 12 12 12 12 21 21 0 0 0 0 0 0 0 0 0 0
21 21 21 21 21 12 12 12 12 12 12 12 12 12 12 12 12 21 21 21 0 0 0 0 0 0 0 0 0 0
21 21 21 21 21 12 12 12 12 12 12 12 12 12 12 21 21 21 21 21 0 0 0 0 0 0 0 0 0 0
21 21 21 21 21 12 12 12 12 12 21 21 21 21 21 21 21 21 21 21 0 0 0 0 0 0 0 0 0 0
21 21 21 21 21 12 12 12 21 21 21 21 21 21 21 21 21 21 21 21 0 0 0 0 0 0 0 0 0 0
21 21 21 21 21 12 12 12 21 21 21 21 21 21 21 21 21 21 21 21 0 0 0 0 0 0 0 0 0 0
21 21 21 21 12 12 12 21 21 21 21 21 21 21 21 21 21 21 21 21 0 0 0 0 0 0 0 0 0 0
21 12 12 12 12 12 12 21 21 21 21 21 21 21 21 21 21 21 21 21 0 0 0 0 0 0 0 0 0 0
21 12 12 12 12 12 12 21 21 21 21 21 21 21 21 21 21 21 21 21 0 0 0 0 0 0 0 0 0 0
21 21 21 21 21 21 21 21 21 21 21 21 21 21 21 21 21 21 21 21 0 0 0 0 0 0 0 0 0 0